0000000000000000
0111100000011110
0100000000000010
0100011001100010
0100011001100010
0100000000000010
0111110000111110
0000000000000000
0000111001110000
0000100000010000
0000100110010000
0000100110010000
0000100000010000
0000111111110000
0000000000000000
0000000000000000