0000000000000000
0001111111111000
0000000000001000
0111111111001000
0100000001001000
0100111001001000
0100101001001000
0100101001001000
0100101001001000
0100101111001000
0100100000001000
0100111111111000
0100000000000000
0111111111111110
0000000000000000
0000000000000000