0000000000000000
0000001111000000
0000001001000000
0000001001000000
0111111001111110
0100000000000010
0100000110000010
0100000110000010
0100000110000010
0100000110000010
0111100110011110
0000000110000000
0000000110000000
0000000110000000
0000000000000000
0000000000000000