0000000000000000
0001111000000000
0000001000111000
0111001000001000
0001001111101000
0001000000101000
0001111110101000
0000000010101000
0011111010101000
0010000010101000
0010111110101000
0010000000101000
0011111111101000
0000000000001000
0000000000001000
0000000000000000