0000000000000000
0000110011000000
0000110011000000
0111100001111000
0100000000001000
0100011111001000
0100010001001000
0100000000001000
0100010001001000
0100011111001000
0100000000001000
0111100001111000
0000110011000000
0000110011000000
0000000000000000
0000000000000000
