0000000000000000
0000000000000000
0010010000111100
0010010000100100
0010010000100100
0010010000100100
0010011111100100
0010000000000100
0010000000000100
0010011111100100
0010010000100100
0010010000100100
0010010000100100
0011110000100100
0000000000000000
0000000000000000
